7  7  7  7  7  7  7  7  7  7  7  7  7  7  7  7  7  7  7  7  7  7  7  7  7  7  7  7  7  7  7  7  7  7  7  7  7  7  7  7  7  7  7  7  7  7  7  7  63  60  4  59  64  7  7  7  7  7  7  7  7  7  7  7  
7  7  7  7  7  7  7  7  7  7  7  7  7  7  7  7  7  7  7  7  7  7  7  7  7  7  7  7  7  7  7  7  7  7  7  7  7  7  7  7  7  7  7  7  7  7  7  7  63  60  4  59  64  7  7  7  7  7  7  7  7  7  7  7  
7  7  7  7  7  7  7  7  7  7  7  7  7  7  7  7  7  7  7  7  7  7  7  7  7  7  7  7  7  7  7  7  7  7  7  7  7  7  7  7  7  7  7  7  7  7  7  7  63  60  4  59  64  7  7  7  7  7  7  7  7  7  7  7  
7  7  7  7  7  7  7  7  7  7  7  7  7  7  7  7  7  7  7  7  7  7  7  7  7  7  7  7  7  7  7  7  7  7  7  7  7  7  7  7  7  7  7  7  7  7  7  7  63  60  4  59  64  7  7  7  7  7  7  7  7  7  7  7  
7  7  7  7  7  7  7  7  7  7  7  7  7  7  7  7  7  7  7  7  7  7  7  7  7  7  7  7  7  7  7  7  7  7  7  7  7  7  7  7  7  7  7  7  7  7  7  7  63  60  4  59  64  7  7  7  7  7  7  7  7  7  7  7  
7  7  7  7  7  7  7  7  7  7  7  7  7  7  7  7  7  7  7  7  7  7  7  7  7  7  7  7  7  7  7  7  7  7  7  7  7  7  7  7  7  7  7  7  7  7  7  7  63  60  4  59  64  7  7  7  7  7  7  7  7  7  7  7  
7  7  7  7  7  7  2  2  2  2  2  2  2  2  2  2  2  2  2  2  2  2  2  2  2  2  2  2  2  2  2  2  2  2  2  2  2  2  2  2  2  2  2  2  2  2  2  2  63  60  4  59  64  2  2  2  2  2  7  7  7  7  7  7  
7  7  7  7  7  7  2  2  2  2  2  2  2  2  2  2  2  2  2  2  2  2  2  2  2  2  2  2  2  2  2  2  2  2  2  2  2  2  2  2  2  2  2  2  2  2  2  2  63  60  4  59  64  2  2  2  2  2  7  7  7  7  7  7  
7  7  7  7  7  7  2  2  2  2  2  2  2  2  2  2  2  2  2  2  2  2  2  2  2  2  2  2  2  2  2  2  2  2  2  2  2  2  2  2  2  2  2  2  2  2  2  2  63  60  4  59  64  2  2  2  2  2  7  7  7  7  7  7  
7  7  7  7  7  7  2  2  2  2  2  2  2  2  2  2  2  2  2  2  2  2  2  2  2  2  2  2  2  2  2  2  2  2  2  2  2  2  2  2  2  2  2  2  2  2  2  2  63  60  4  59  64  2  2  2  2  2  7  7  7  7  7  7  
7  7  7  7  7  7  2  2  2  2  2  2  2  2  2  2  2  2  2  2  2  2  2  2  2  2  2  2  2  2  2  2  2  2  2  2  2  2  2  2  2  2  2  2  2  2  2  77  98  70  4  59  64  2  2  2  2  2  7  7  7  7  7  7  
7  7  7  7  7  7  2  2  2  2  2  2  2  2  2  2  2  2  2  2  2  2  2  2  2  2  2  2  2  2  2  2  2  2  2  2  2  2  2  2  2  2  2  2  2  2  2  111  1  103  4  59  64  2  2  2  2  2  7  7  7  7  7  7  
7  7  7  7  7  7  2  2  2  2  2  2  2  2  2  2  2  2  2  2  2  2  2  2  2  2  2  2  2  2  2  2  2  2  2  2  2  2  2  2  2  2  2  2  2  2  2  93  97  86  4  59  64  2  2  2  2  2  7  7  7  7  7  7  
62  62  62  62  62  62  62  62  62  62  62  62  62  62  30  2  2  2  2  2  2  2  2  2  2  2  2  2  2  2  2  2  2  2  2  2  2  2  2  2  2  2  2  2  2  2  2  2  63  60  4  59  64  2  2  2  2  2  7  7  7  7  7  7  
57  57  57  57  57  57  57  57  57  57  57  57  57  28  64  2  2  2  2  2  2  2  2  2  2  2  2  2  2  2  2  2  2  2  2  2  2  2  2  2  2  2  2  2  2  2  2  2  63  60  4  59  64  2  2  2  2  2  7  7  7  7  7  7  
4  4  4  4  4  4  10  4  4  4  4  4  4  59  64  2  2  2  2  2  2  2  2  2  2  2  2  2  2  2  2  2  2  2  2  2  2  2  2  2  2  2  2  2  2  2  2  2  63  60  4  59  64  2  2  2  2  2  7  7  7  7  7  7  
58  58  58  58  58  58  58  58  58  58  26  4  4  59  64  2  2  2  2  2  2  2  2  2  2  2  2  2  2  2  2  2  2  2  2  2  2  2  2  2  2  2  2  2  2  2  2  2  63  60  4  59  64  2  2  2  2  2  7  7  7  7  7  7  
61  61  61  61  61  61  61  61  61  32  60  4  4  59  64  2  2  2  2  2  2  2  2  2  2  2  2  2  2  2  2  2  2  2  2  2  2  2  2  2  2  2  2  2  2  2  2  2  63  60  4  59  64  2  2  2  2  2  7  7  7  7  7  7  
7  7  7  7  7  7  2  2  2  63  60  4  4  59  47  62  62  62  62  62  62  62  62  30  2  2  2  2  2  2  2  2  2  2  2  2  2  2  2  2  2  2  2  2  2  2  2  2  63  60  4  59  64  2  2  2  2  2  7  7  7  7  7  7  
7  7  7  7  7  7  2  2  2  63  60  4  4  41  57  57  57  57  57  57  57  57  28  64  2  2  2  2  2  2  2  2  2  2  2  2  2  2  2  2  2  2  2  2  2  2  2  2  63  60  4  59  64  2  2  2  2  2  7  7  7  7  7  7  
7  7  7  7  7  7  2  2  2  63  60  4  4  4  4  4  4  4  4  4  4  4  59  64  2  2  2  2  2  2  2  2  2  2  2  29  62  62  62  62  62  62  62  62  62  62  62  62  48  60  4  59  64  2  2  2  2  2  7  7  7  7  7  7  
7  7  7  7  7  7  2  2  2  63  43  58  58  58  58  58  58  58  58  58  26  4  59  64  2  2  2  2  2  2  2  2  2  2  2  63  27  57  57  57  57  57  57  57  57  57  57  57  57  42  4  59  64  2  2  2  2  2  7  7  7  7  7  7  
7  7  7  7  7  7  2  2  2  45  61  61  61  61  61  61  61  61  61  32  60  4  59  64  2  2  2  2  2  2  2  2  2  2  2  63  60  4  4  4  4  4  4  4  4  4  4  4  4  4  4  59  64  2  2  2  2  2  7  7  7  7  7  7  
7  7  7  7  7  7  2  2  2  2  2  2  2  2  2  2  2  2  2  63  60  4  59  64  2  2  2  2  2  2  2  2  2  2  2  63  60  4  25  58  58  58  58  58  58  58  58  58  58  58  58  44  64  2  2  2  2  2  7  7  7  7  7  7  
7  7  7  7  7  7  2  2  2  2  2  2  2  2  2  2  2  2  2  63  60  4  59  47  30  2  2  2  2  2  2  2  2  2  2  63  60  4  59  31  61  61  61  61  61  61  61  61  61  61  61  61  46  2  2  2  2  2  7  7  7  7  7  7  
7  7  7  7  7  7  2  2  2  2  2  2  2  2  2  2  2  2  2  63  60  4  41  28  64  2  2  2  2  2  2  2  2  2  2  63  60  4  59  64  2  2  2  2  2  2  2  2  2  2  2  2  2  2  2  2  2  2  7  7  7  7  7  7  
7  7  7  7  7  7  2  2  2  2  2  2  2  2  2  2  2  2  2  63  60  4  4  59  64  2  2  2  2  2  2  2  2  2  2  63  60  4  59  64  2  2  2  2  2  2  2  2  2  2  2  2  2  2  2  2  2  2  7  7  7  7  7  7  
7  7  7  7  7  7  2  2  2  2  2  2  2  2  2  2  2  2  2  63  60  4  4  59  64  2  2  2  2  2  2  2  2  2  2  63  60  4  59  64  2  2  2  2  2  2  2  2  2  2  2  2  2  2  2  2  2  2  7  7  7  7  7  7  
7  7  7  7  7  7  2  2  2  2  2  2  2  2  2  2  2  2  2  63  43  26  4  59  64  2  2  2  2  2  2  2  2  2  2  63  60  4  59  64  2  2  2  2  2  2  2  2  2  2  2  2  2  2  2  2  2  2  7  7  7  7  7  7  
7  7  7  7  7  7  2  2  2  2  2  2  2  2  17  49  49  49  18  45  32  60  4  59  64  2  2  2  2  2  2  2  2  2  2  63  60  4  59  64  2  2  2  2  2  2  2  2  2  2  2  2  2  2  2  2  2  2  7  7  7  7  7  7  
7  7  7  7  7  7  2  2  2  2  2  2  2  2  52  3  3  3  51  2  63  60  4  59  64  2  2  2  2  2  2  2  2  2  2  63  60  4  59  64  2  2  2  2  2  2  2  2  2  2  2  2  2  2  2  2  2  2  7  7  7  7  7  7  
7  7  7  7  7  7  2  2  2  2  2  2  2  17  36  3  3  3  35  18  63  60  4  59  47  62  62  62  62  62  62  62  62  62  62  48  60  4  59  64  2  2  2  2  2  2  2  2  2  2  2  2  2  2  2  2  2  2  7  7  7  7  7  7  
7  7  7  7  7  7  2  2  2  2  2  2  2  52  3  3  3  3  3  51  63  60  4  41  57  57  57  57  57  57  57  57  57  57  57  57  42  4  59  64  2  2  2  2  2  2  2  2  2  2  2  2  2  2  2  2  2  2  7  7  7  7  7  7  
7  7  7  7  7  7  2  2  2  2  2  2  2  52  3  3  3  3  3  51  63  60  4  4  4  4  4  4  4  4  4  4  4  4  4  4  4  4  59  64  2  2  2  2  2  2  2  2  2  2  2  2  2  2  2  2  2  2  7  7  7  7  7  7  
7  7  7  7  7  7  2  2  2  2  2  2  2  33  50  20  3  3  19  34  63  43  58  58  58  58  58  26  4  25  58  58  58  58  58  58  58  58  44  64  2  2  2  2  2  2  2  2  2  2  2  2  2  2  2  2  2  2  7  7  7  7  7  7  
7  7  7  7  7  7  2  2  2  2  2  2  2  2  2  33  50  50  34  2  45  61  61  61  61  61  32  60  4  59  31  61  61  61  61  61  61  61  61  46  2  2  2  2  2  2  2  2  2  2  2  2  2  2  2  2  2  2  7  7  7  7  7  7  
7  7  7  7  7  7  2  2  2  2  2  2  2  2  2  2  2  2  2  2  2  2  2  2  2  2  63  60  4  59  64  2  2  2  2  2  2  2  2  2  2  2  2  2  2  2  2  2  2  2  2  2  2  2  2  2  2  2  7  7  7  7  7  7  
7  7  7  7  7  7  2  2  2  2  2  2  2  2  2  2  2  2  2  2  2  2  2  2  2  2  63  60  4  59  64  2  2  2  2  2  2  2  17  49  18  2  2  2  2  2  2  2  2  2  2  2  2  2  2  2  2  2  7  7  7  7  7  7  
7  7  7  7  7  7  2  2  2  2  2  2  2  2  2  2  2  2  2  2  2  2  2  2  2  2  63  60  4  59  47  62  30  2  2  2  2  17  36  3  35  18  2  2  2  2  2  2  2  2  2  2  2  2  2  2  2  2  7  7  7  7  7  7  
7  7  7  7  7  7  2  2  2  2  2  2  2  2  2  2  2  2  2  2  2  2  2  2  2  2  63  60  4  41  57  28  64  2  2  17  49  36  3  3  3  51  2  2  2  2  2  2  2  2  2  2  2  2  2  2  2  2  7  7  7  7  7  7  
7  7  7  7  7  7  2  2  2  2  2  2  2  2  2  2  2  2  2  2  2  2  2  2  2  2  63  60  4  4  4  59  64  2  17  36  3  3  3  3  3  51  2  2  2  2  2  2  2  2  2  2  2  2  2  2  2  2  7  7  7  7  7  7  
7  7  7  7  7  7  2  2  2  2  2  2  2  2  2  2  2  2  2  2  2  2  2  2  2  2  63  43  58  26  4  59  64  2  52  3  3  3  3  3  3  51  2  2  2  2  2  2  2  2  2  2  2  2  2  2  2  2  7  7  7  7  7  7  
7  7  7  7  7  7  2  2  2  2  2  2  2  2  2  2  2  2  2  2  2  2  2  2  2  2  45  61  32  60  4  59  64  2  52  3  3  3  3  3  19  34  2  2  2  2  2  2  2  29  62  62  62  62  62  62  62  62  62  62  62  62  62  62  
7  7  7  7  7  7  2  2  2  2  2  2  2  2  2  2  2  2  2  2  2  2  2  2  2  2  2  2  63  60  4  59  64  2  33  50  50  50  50  50  34  2  2  2  2  2  2  2  2  63  27  57  57  57  57  57  57  57  57  57  57  57  57  57  
7  7  7  7  7  7  2  2  2  2  2  2  2  2  2  2  17  49  49  49  49  49  18  2  2  2  2  2  63  60  4  59  64  2  2  2  2  2  2  2  2  2  2  2  2  2  2  2  2  63  60  4  4  4  4  4  4  4  4  4  4  4  4  4  
7  7  7  7  7  7  2  2  2  2  2  2  2  17  49  49  36  3  3  19  50  50  34  2  2  2  2  2  63  60  4  59  64  2  2  2  2  2  2  2  2  2  2  2  2  2  2  2  2  63  60  4  25  58  58  58  58  58  58  58  58  58  58  58  
7  7  7  7  7  7  2  2  2  2  2  2  2  52  3  3  3  3  3  51  29  62  62  62  62  62  62  62  48  60  4  59  47  62  62  62  62  62  62  62  62  62  62  62  62  62  62  62  62  48  60  4  59  31  61  61  61  61  61  61  61  61  61  61  
7  7  7  7  7  7  2  2  2  2  2  2  2  33  20  3  3  3  3  51  63  27  57  57  57  57  57  57  57  42  4  41  57  57  57  57  57  57  57  57  57  57  57  57  57  57  57  57  57  57  42  4  59  64  2  2  2  2  7  7  7  7  7  7  
7  7  7  7  7  7  2  2  2  2  2  2  2  2  33  50  50  50  50  34  63  60  4  4  4  4  4  4  4  4  4  4  4  4  4  4  4  4  4  4  4  4  4  4  4  4  4  4  4  4  4  4  59  64  2  2  2  2  7  7  7  7  7  7  
7  7  7  7  7  7  2  2  2  2  2  2  2  2  2  2  2  2  2  2  63  60  4  25  58  58  58  58  58  58  58  58  58  26  4  25  58  58  58  58  58  58  58  58  58  58  58  58  58  58  58  58  44  64  2  2  2  2  7  7  7  7  7  7  
7  7  7  7  7  7  2  2  2  2  2  2  2  2  2  29  62  62  62  62  48  60  4  59  31  61  61  61  61  61  61  61  32  60  4  59  31  61  61  61  61  61  61  61  61  61  61  61  61  61  61  61  61  46  2  2  2  2  7  7  7  7  7  7  
7  7  7  7  7  7  2  2  2  2  2  2  2  2  2  63  27  57  57  57  57  42  4  59  64  2  2  2  2  2  2  2  63  60  4  59  64  2  2  2  2  2  2  2  2  2  2  2  2  2  2  17  49  49  18  2  2  2  7  7  7  7  7  7  
7  7  7  7  7  7  2  2  2  2  2  2  2  2  2  63  60  4  4  4  4  4  4  59  64  2  2  2  2  2  2  2  63  60  4  59  64  2  2  2  2  2  2  2  2  2  2  49  49  49  49  36  3  3  51  2  2  2  7  7  7  7  7  7  
7  7  7  7  7  7  2  2  2  2  2  2  2  2  2  63  60  4  25  58  58  58  58  44  64  2  2  2  2  2  2  2  63  60  4  59  64  2  2  2  2  2  2  2  2  17  49  3  3  3  3  3  3  3  51  2  2  2  7  7  7  7  7  7  
7  7  7  7  7  7  2  2  2  2  2  2  2  2  2  63  60  4  59  31  61  61  61  61  46  2  2  2  2  2  2  2  63  60  4  59  64  2  2  2  2  2  2  2  2  52  3  3  3  3  3  3  3  3  51  2  2  2  7  7  7  7  7  7  
7  7  7  7  7  7  2  2  2  2  2  2  2  2  2  63  60  4  59  64  2  2  2  2  2  2  2  2  2  2  2  2  63  60  4  59  64  2  2  2  2  2  2  2  2  52  3  3  3  3  19  50  50  50  34  2  2  2  7  7  7  7  7  7  
7  7  7  7  7  7  2  2  2  2  2  2  2  2  2  63  60  4  59  64  2  2  2  2  2  2  2  2  2  2  2  2  63  60  4  59  64  2  2  2  2  2  2  2  2  33  50  50  50  50  34  2  2  2  2  2  2  2  7  7  7  7  7  7  
7  7  7  7  7  7  2  2  2  2  2  2  2  2  2  63  60  4  59  64  2  2  2  2  2  2  2  2  2  2  2  2  63  60  4  59  64  2  2  2  2  2  2  2  2  2  2  2  2  2  2  2  2  2  2  2  2  2  7  7  7  7  7  7  
7  7  7  7  7  7  7  7  7  7  7  7  7  7  7  63  60  4  59  64  7  7  7  7  7  7  7  7  7  7  7  7  63  60  4  59  64  7  7  7  7  7  7  7  7  7  7  7  7  7  7  7  7  7  7  7  7  7  7  7  7  7  7  7  
7  7  7  7  7  7  7  7  7  7  7  7  7  7  7  63  60  4  59  64  7  7  7  7  7  7  7  7  7  7  7  7  63  60  4  59  64  7  7  7  7  7  7  7  7  7  7  7  7  7  7  7  7  7  7  7  7  7  7  7  7  7  7  7  
7  7  7  7  7  7  7  7  7  7  7  7  7  7  7  63  60  4  59  64  7  7  7  7  7  7  7  7  7  7  7  7  63  60  4  59  64  7  7  7  7  7  7  7  7  7  7  7  7  7  7  7  7  7  7  7  7  7  7  7  7  7  7  7  
7  7  7  7  7  7  7  7  7  7  7  7  7  7  7  63  60  4  59  64  7  7  7  7  7  7  7  7  7  7  7  7  63  60  4  59  64  7  7  7  7  7  7  7  7  7  7  7  7  7  7  7  7  7  7  7  7  7  7  7  7  7  7  7  
7  7  7  7  7  7  7  7  7  7  7  7  7  7  7  63  60  4  59  64  7  7  7  7  7  7  7  7  7  7  7  7  63  60  4  59  64  7  7  7  7  7  7  7  7  7  7  7  7  7  7  7  7  7  7  7  7  7  7  7  7  7  7  7  
7  7  7  7  7  7  7  7  7  7  7  7  7  7  7  63  60  4  59  64  7  7  7  7  7  7  7  7  7  7  7  7  63  60  4  59  64  7  7  7  7  7  7  7  7  7  7  7  7  7  7  7  7  7  7  7  7  7  7  7  7  7  7  7